# Special countries..
REB = "countries/Rebels.txt"
PIR = "countries/Pirates.txt"
NAT = "countries/Natives.txt"

#IMPORTANT NOTE
#the following letters can not be used for the 
#A01, A02, A03... etc format:
# K, C, D, E, T
AAA = "countries/Tenochtitlan.txt"
AAB = "countries/Tlatelolco.txt"
ACC = "countries/Texcoco.txt"
AAD = "countries/Tlacopan.txt"
AAE = "countries/Azcapotzalco.txt"
AAF = "countries/Tenayuca.txt"
AAG = "countries/Tepeyac.txt"
AAH = "countries/Ecatepec.txt"
AAI = "countries/Tepotzotlan.txt"
AAJ = "countries/Cuauhtitlan.txt"
AAK = "countries/Citlaltepec.txt"
AAL = "countries/Xaltocan.txt"
AAM = "countries/Tizayocan.txt"
AAN = "countries/Zumpanco.txt"
AAO = "countries/Chiconautla.txt"
AAP = "countries/Acolman.txt"
AAQ = "countries/Teotihuacan.txt"
AAR = "countries/Otumba.txt"
AAS = "countries/Tepechpan.txt"
AAT = "countries/Tetzonyocan.txt"
AAU = "countries/Tepetlaoztoc.txt"
AAV = "countries/Chiauhtla.txt"
AAW = "countries/Huexotla.txt"
AAX = "countries/Coatlinchan.txt"
AAY = "countries/Chimalhuacan.txt"
AAZ = "countries/Mexicatzinco.txt"
BBA = "countries/Colhuacan.txt"
BBB = "countries/Ixtapalapa.txt"
BBC = "countries/Itztapollocan.txt"
BBD = "countries/Chalco.txt"
BBE = "countries/Mizquic.txt"
BBF = "countries/Cuitlahuac.txt"
BBG = "countries/Xochimilco.txt"
BBH = "countries/Huitzilopocho.txt"
BBI = "countries/Coyohuacan.txt"
BBJ = "countries/Tlalmanalco.txt"
BBK = "countries/Tenanco.txt"
BBL = "countries/Amecameca.txt"
BBM = "countries/Tepetlixtlan.txt"
BBN = "countries/Atlauhtla.txt"
BBO = "countries/Ayotzinco.txt"
BBP = "countries/Tzintzuntzan.txt"
BBQ = "countries/Itziparamucu.txt"
BBR = "countries/Uayameo.txt"
BBS = "countries/PacandanXaraquaro.txt"
BBT = "countries/Eronguariquaro.txt"
BBU = "countries/Urichu.txt"
BBV = "countries/Pareo.txt"
BBW = "countries/Patzcuaro.txt"
BBX = "countries/Ihuatzio.txt"
BBY = "countries/Pechataro.txt"
BBZ = "countries/Matujeo.txt"
CCA = "countries/Coringuaro.txt"
CCB = "countries/Tiripitio.txt"
CCC = "countries/Undameo.txt"
CCD = "countries/Etucuaro.txt"
CCE = "countries/Zirahuen.txt"
CCF = "countries/Zurumucapio.txt"
CCG = "countries/Uruapan.txt"
CCH = "countries/Taretan.txt"
CCI = "countries/Urecho.txt"
CCJ = "countries/Tarindaro.txt"
CCK = "countries/Comanchen.txt"
CCL = "countries/Zacapu.txt"
CCM = "countries/Naranjan.txt"
CCN = "countries/Nahuatzin.txt"
CCO = "countries/Xaso.txt"
CCP = "countries/Taremeado.txt"
CCQ = "countries/Huaniqueo.txt"
CCR = "countries/Chucandiro.txt"
CCS = "countries/Copoyo.txt"
CCT = "countries/Cuitzeo.txt"
CCU = "countries/Jeruco.txt"
CCV = "countries/Andocutin.txt"
CCW = "countries/Araro.txt"
CCX = "countries/Indaparapeo.txt"
CCY = "countries/Cherani.txt"
CCZ = "countries/Aran.txt"
DDA = "countries/Comanchuen.txt"
DDB = "countries/Charapan.txt"
DDC = "countries/Aranja.txt"
DDD = "countries/Paracho.txt"
DDE = "countries/Tacambaro.txt"
DDF = "countries/Uruapa.txt"
DDG = "countries/Guacana.txt"
DDH = "countries/Turicato.txt"
DDI = "countries/Puruaran.txt"
DDJ = "countries/Cutzian.txt"
DDK = "countries/Acuyo.txt"
DDL = "countries/Zirondaro.txt"
DDM = "countries/Balsas.txt"
DDN = "countries/Cuseo.txt"
DDO = "countries/Churumuco.txt"
DDP = "countries/Sinagua.txt"
DDQ = "countries/Cutzamala.txt"
DDR = "countries/PungariHoato.txt"
DDS = "countries/Coyuca.txt"
DDT = "countries/Changata.txt"
DDU = "countries/Ajuchitlan.txt"
DDV = "countries/Tlalpehala.txt"
DDW = "countries/Tlalchapa.txt"
DDX = "countries/Zitacuaro.txt"
DDY = "countries/Jungapeo.txt"
DDZ = "countries/Taximaroa.txt"
EEA = "countries/Ucareo.txt"
EEB = "countries/Maravatio.txt"
EEC = "countries/Zinapecuaro.txt"
EED = "countries/Querendaro.txt"
EEE = "countries/Charo.txt"
EEF = "countries/Haripareo.txt"
EEG = "countries/Guayangareo.txt"
EEH = "countries/Tarimbaro.txt"
EEI = "countries/Taristaran.txt"
EEJ = "countries/Xengaro.txt"
EEK = "countries/Zipiajo.txt"
EEL = "countries/Coeneo.txt"
EEM = "countries/Acambaro.txt"
EEN = "countries/Mayao.txt"
EEO = "countries/Yuririapundaro.txt"
EEP = "countries/Uriangato.txt"
EEQ = "countries/Huango.txt"
EER = "countries/Puruandiro.txt"
EES = "countries/Copandaro.txt"
EET = "countries/Zinaparo.txt"
EEU = "countries/Acacuato.txt"
EEV = "countries/Numaran.txt"
EEW = "countries/Ecuandureo.txt"
EEX = "countries/Tlazazalca.txt"
EEY = "countries/Angamucutiro.txt"
EEZ = "countries/Panindicuaro.txt"
FFA = "countries/Carapan.txt"
FFB = "countries/Chilchota.txt"
FFC = "countries/Yurecuaro.txt"
FFD = "countries/Ixtlan.txt"
FFE = "countries/Pajacuaran.txt"
FFF = "countries/Sahuayo.txt"
FFG = "countries/Jiquilpan.txt"
FFH = "countries/Xacona.txt"
FFI = "countries/Tarecuato.txt"
FFJ = "countries/Cotija.txt"
FFK = "countries/Capacuaro.txt"
FFL = "countries/Angahuen.txt"
FFM = "countries/Zirosto.txt"
FFN = "countries/Periban.txt"
FFO = "countries/Chocandiran.txt"
FFP = "countries/Tinguindin.txt"
FFQ = "countries/Tacatzcuaro.txt"
FFR = "countries/Ario.txt"
FFS = "countries/Capirio.txt"
FFT = "countries/Arimeo.txt"
FFU = "countries/Pinzandaro.txt"
FFV = "countries/Tomatlan.txt"
FFW = "countries/Apatzingan.txt"
FFX = "countries/Condembaro.txt"
FFY = "countries/Tancitaro.txt"
FFZ = "countries/Paracuaro.txt"
GGA = "countries/Charapendo.txt"
GGB = "countries/Eruzio.txt"
GGC = "countries/Xilotlan.txt"
GGD = "countries/Tafetan.txt"
GGE = "countries/Tuzantla.txt"
GGF = "countries/Tlquicheo.txt"
GGG = "countries/ZacapuHoato.txt"
GGH = "countries/Cutzio.txt"
GGI = "countries/Huetamo.txt"
GGJ = "countries/Tamazula.txt"
GGK = "countries/Tuxpan.txt"
GGL = "countries/Zapotlan.txt"
GGM = "countries/Coalcoman.txt"
GGN = "countries/ParacuaroKundenbarani.txt"
GGO = "countries/Jerecuaro.txt"
GGP = "countries/Tungareo.txt"
GGQ = "countries/Araceo.txt"
GGR = "countries/Huanimaro.txt"
GGS = "countries/Penjamo.txt"
GGT = "countries/Zacatula.txt"
GGU = "countries/Ayotac.txt"
GGV = "countries/Acalpican.txt"
GGW = "countries/Nexpa.txt"
GGX = "countries/Motin.txt"
GGY = "countries/Coahuayana.txt"
GGZ = "countries/Armeria.txt"
HHA = "countries/Acoliman.txt"
HHB = "countries/Autlan.txt"
HHC = "countries/Sayula.txt"
HHD = "countries/Zacoalco.txt"
HHE = "countries/Tonala.txt"
HHF = "countries/Etzatlan.txt"
HHG = "countries/Teul.txt"
HHH = "countries/Juchipila.txt"
HHI = "countries/Tlatenanco.txt"
HHJ = "countries/Jalpa.txt"
HHK = "countries/Nochistlan.txt"
HHL = "countries/Tuitlan.txt"
HHM = "countries/Analco.txt"
HHN = "countries/Chiapan.txt"
HHO = "countries/Tepexic.txt"
HHP = "countries/Tlautla.txt"
HHQ = "countries/Xochitlan.txt"
HHR = "countries/Xipacoyan.txt"
HHS = "countries/Atitlalaquian.txt"
HHT = "countries/Tollan.txt"
HHU = "countries/Nextlalpan.txt"
HHV = "countries/Tezontepec.txt"
HHW = "countries/Chilcuautla.txt"
HHX = "countries/Otlazpan.txt"
HHY = "countries/Atotonilco.txt"
HHZ = "countries/Axocopan.txt"
IIA = "countries/Tlahuililpan.txt"
IIB = "countries/Mizquiyahuala.txt"
IIC = "countries/Tezcatepec.txt"
IID = "countries/Tecpatepec.txt"
IIE = "countries/Yetecomac.txt"
IIF = "countries/Ixmiquilpan.txt"
IIG = "countries/Xilotepec.txt"
IIH = "countries/Tzayanquilpan.txt"
III = "countries/Michmaloyan.txt"
IIJ = "countries/Tepetitlan.txt"
IIK = "countries/Tlachco.txt"
IIL = "countries/Acoxochitlan.txt"
IIM = "countries/Acahualzinco.txt"
IIN = "countries/Hueychiapan.txt"
IIO = "countries/Tecozauhtlan.txt"
IIP = "countries/Zimpan.txt"
IIQ = "countries/Nenamicoyan.txt"
IIR = "countries/Acolco.txt"
IIS = "countries/Amealco.txt"
IIT = "countries/Orizaua.txt"
IIU = "countries/Tlacotlapilco.txt"
IIV = "countries/Atlacomulco.txt"
IIW = "countries/Xocotitlan.txt"
IIX = "countries/Ixtlahuaca.txt"
IIY = "countries/Xiquipilco.txt"
IIZ = "countries/Malacatepec.txt"
JJA = "countries/Necantepec.txt"
JJB = "countries/Tecaxic.txt"
JJC = "countries/Tzinacantepec.txt"
JJD = "countries/Tlalchichilpa.txt"
JJE = "countries/Ocelotepec.txt"
JJF = "countries/Cuahuacan.txt"
JJG = "countries/Huizquilocan.txt"
JJH = "countries/Cuaximalpan.txt"
JJI = "countries/Huitzizalpan.txt"
JJJ = "countries/Chichicuautla.txt"
JJK = "countries/Tlalachco.txt"
JJL = "countries/Cuauhpanoyan.txt"
JJM = "countries/Atlapulco.txt"
JJN = "countries/Tlalatlauhco.txt"
JJO = "countries/Calpulhuac.txt"
JJP = "countries/Coatepec.txt"
JJQ = "countries/Ocotepec.txt"
JJR = "countries/Xicaltepec.txt"
JJS = "countries/Tollocan.txt"
JJT = "countries/Metepec.txt"
JJU = "countries/Tlacotepec.txt"
JJV = "countries/Tepemaxalco.txt"
JJW = "countries/Caliymaya.txt"
JJX = "countries/Teotenanco.txt"
JJY = "countries/Atlatlauhco.txt"
JJZ = "countries/Xochiaca.txt"
KKA = "countries/Tepexoyuca.txt"
KKB = "countries/Tenantzinco.txt"
KKC = "countries/Tonatiuhco.txt"
KKD = "countries/Malinalco.txt"
KKE = "countries/Zumpahuacan.txt"
KKF = "countries/Ocuilan.txt"
KKG = "countries/Pilcayan.txt"
KKH = "countries/Nochtepec.txt"
KKI = "countries/Acuitlapan.txt"
KKJ = "countries/Teticpac.txt"
KKL = "countries/Chontalcoatlan.txt"
KKM = "countries/Axamixtlahuaca.txt"
KKN = "countries/Tetenanco.txt"
KKO = "countries/Atzala.txt"
KKP = "countries/HueyTlachco.txt"
KKQ = "countries/Teotliztacan.txt"
KKR = "countries/Tlamacazapa.txt"
KKS = "countries/Tzicapotzalco.txt"
KKT = "countries/Ixtapan.txt"
KKU = "countries/Zacualpan.txt"
KKV = "countries/Acuitlapilco.txt"
KKW = "countries/Atlamoloyan.txt"
KKX = "countries/Texcaltitlan.txt"
KKY = "countries/Zultepec.txt"
KKZ = "countries/Temazcaltepec.txt"
LLA = "countries/Texupilco.txt"
LLB = "countries/Amatepec.txt"
LLC = "countries/Tlatlayan.txt"
LLD = "countries/Huitzillapan.txt"
LLE = "countries/Ixtepec.txt"
LLF = "countries/Cuauhnahuac.txt"
LLG = "countries/Xiuhtepec.txt"
LLH = "countries/Cohuintepec.txt"
LLI = "countries/Acatlipac.txt"
LLJ = "countries/Xochitepec.txt"
LLK = "countries/Tezoyucan.txt"
LLL = "countries/Amatitlan.txt"
LLM = "countries/Miacatlan.txt"
LLN = "countries/Atlpoyecan.txt"
LLO = "countries/Atlicholoayan.txt"
LLP = "countries/Timimilcinco.txt"
LLQ = "countries/Molotlan.txt"
LLR = "countries/Mazatepec.txt"
LLS = "countries/Coatlan.txt"
LLT = "countries/Cuauhchichinollan.txt"
LLU = "countries/IxtlanCuauhnahuac.txt"
LLV = "countries/Amacoztitlan.txt"
LLW = "countries/Ocpayucan.txt"
LLX = "countries/Tehuixtlan.txt"
LLY = "countries/Tequexquitenco.txt"
LLZ = "countries/Zacatepec.txt"
MMA = "countries/Tlaquiltenanco.txt"
MMB = "countries/Xoxotlan.txt"
MMC = "countries/Panchimalco.txt"
MMD = "countries/Teocalcinco.txt"
MME = "countries/Tepoztlan.txt"
MMF = "countries/Yauhtepec.txt"
MMG = "countries/Tlaltizapan.txt"
MMH = "countries/Nepopoalco.txt"
MMI = "countries/Tehuixco.txt"
MMJ = "countries/Totolapan.txt"
MMK = "countries/Tlayecapan.txt"
MML = "countries/Coacalco.txt"
MMM = "countries/Ixtamatitlan.txt"
MMN = "countries/Atlhuelican.txt"
MMO = "countries/Atlatlauhcan.txt"
MMP = "countries/Yacapiztlan.txt"
MMQ = "countries/Huaxtepec.txt"
MMR = "countries/Xochimilcatzinco.txt"
MMS = "countries/ZumpancoHuaxtepec.txt"
MMT = "countries/Ahuehuepan.txt"
MMU = "countries/Cuauhtlixco.txt"
MMV = "countries/Amilcinco.txt"
MMW = "countries/Anenecuilco.txt"
MMX = "countries/Cuauhtlan.txt"
MMY = "countries/Tlayecac.txt"
MMZ = "countries/Ollintepec.txt"
NNA = "countries/Xoloztoc.txt"
NNB = "countries/Huitzillan.txt"
NNC = "countries/Xonacatepec.txt"
NND = "countries/AtotonilcoHuaxtepec.txt"
NNE = "countries/Tecpantzinco.txt"
NNF = "countries/Axochiapan.txt"
NNG = "countries/Tetellan.txt"
NNH = "countries/Xantelelco.txt"
NNI = "countries/Amayucan.txt"
NNJ = "countries/Cuauhzolco.txt"
NNK = "countries/Temoac.txt"
NNL = "countries/ZacualpanOcuituco.txt"
NNM = "countries/TlacotepecOcuituco.txt"
NNN = "countries/Ocuituco.txt"
NNO = "countries/Itztlan.txt"
NNP = "countries/Xumiltepec.txt"
NNQ = "countries/Acatzinco.txt"
NNR = "countries/NepopoalcoOcuituco.txt"
NNS = "countries/Hueyapan.txt"
NNT = "countries/Teotlalco.txt"
NNU = "countries/Centeopan.txt"
NNV = "countries/Xolalpan.txt"
NNW = "countries/Teutla.txt"
NNX = "countries/Mitepec.txt"
NNY = "countries/Huehuetlan.txt"
NNZ = "countries/Chiauhtlan.txt"
OOA = "countries/Cuetzalan.txt"
OOB = "countries/Xicotlan.txt"
OOC = "countries/Ocotlan.txt"
OOD = "countries/Huamuchtitlan.txt"
OOE = "countries/Cuauhtecomatlan.txt"
OOF = "countries/Olinalan.txt"
OOG = "countries/Cualac.txt"
OOH = "countries/Teohuaxtitlan.txt"
OOI = "countries/Quiauhteopan.txt"
OOJ = "countries/Oztutlan.txt"
OOK = "countries/Mezquitlan.txt"
OOL = "countries/Pochotlan.txt"
OOM = "countries/Ahuacuatzinco.txt"
OON = "countries/Mitzinco.txt"
OOO = "countries/Tlacozauhtitlan.txt"
OOP = "countries/Tollimani.txt"
OOQ = "countries/Atenanco.txt"
OOR = "countries/Huitzoco.txt"
OOS = "countries/Tlachmalacac.txt"
OOT = "countries/Tepecuaquilco.txt"
OOU = "countries/Mazatlan.txt"
OOV = "countries/Ohuapan.txt"
OOW = "countries/Chilapan.txt"
OOX = "countries/Quecholtenanco.txt"
OOY = "countries/Yoallan.txt"
OOZ = "countries/Cocolan.txt"
PPA = "countries/CoatepecTepecuaquilco.txt"
PPB = "countries/Chilacachapa.txt"
PPC = "countries/CuetzalanTepecuaquilco.txt"
PPD = "countries/Tenepantla.txt"
PPE = "countries/Ixcateopan.txt"
PPF = "countries/Teloloapan.txt"
PPG = "countries/Oztoma.txt"
PPH = "countries/Acapetlahuayan.txt"
PPI = "countries/Alahuiztlan.txt"
PPJ = "countries/Totoltepec.txt"
PPK = "countries/HueyTetellan.txt"
PPL = "countries/TonalliImoquetzayan.txt"
PPM = "countries/TlacotepecTetellan.txt"
PPN = "countries/Otatlan.txt"
PPO = "countries/Calpulalcolulco.txt"
PPP = "countries/Huitziltepec.txt"
PPQ = "countries/Tixtla.txt"
PPR = "countries/Mochitlan.txt"
PPS = "countries/Zompanco.txt"
PPT = "countries/Atliztacan.txt"
PPU = "countries/Tlanchinollan.txt"
PPV = "countries/Petlacallan.txt"
PPW = "countries/Chiepetlan.txt"
PPX = "countries/Tlapan.txt"
PPY = "countries/Ocoapan.txt"
PPZ = "countries/TetenancoTlapan.txt"
QQA = "countries/Totomixtlahuacan.txt"
QQB = "countries/Malinaltepec.txt"
QQC = "countries/IxcateopanTlapan.txt"
QQD = "countries/Ahuacatlan.txt"
QQE = "countries/Amaxac.txt"
QQF = "countries/YoallanTlapan.txt"
QQG = "countries/AcuitlapanTlapan.txt"
QQH = "countries/Caltitlan.txt"
QQI = "countries/Yoallapan.txt"
QQJ = "countries/Tlacolula.txt"
QQK = "countries/Ometepec.txt"
QQL = "countries/Xochixtlahuacan.txt"
QQM = "countries/Ayotzinapan.txt"
QQN = "countries/Atzoyoc.txt"
QQO = "countries/Acatlan.txt"
QQP = "countries/Zintla.txt"
QQQ = "countries/Copalitech.txt"
QQR = "countries/Cuilutlan.txt"
QQS = "countries/Cuauhtepec.txt"
QQT = "countries/Xalapan.txt"
QQU = "countries/Nexpan.txt"
QQV = "countries/Xochitonallan.txt"
QQW = "countries/Tototepec.txt"
QQX = "countries/Ayotlan.txt"
QQY = "countries/Cuahuitlan.txt"
QQZ = "countries/Acapolco.txt"
RRA = "countries/Mictlan.txt"
RRB = "countries/Coyaco.txt"
RRC = "countries/Citlaltomahua.txt"
RRD = "countries/Cacalutlan.txt"
RRE = "countries/Tecpantepec.txt"
RRF = "countries/Noxcoc.txt"
RRG = "countries/Cihuatlan.txt"
RRH = "countries/Panotlan.txt"
RRI = "countries/Coyocac.txt"
RRJ = "countries/Nantzintlan.txt"
RRK = "countries/Axapotecan.txt"
RRL = "countries/Xolochiuhyan.txt"
RRM = "countries/Petlatlan.txt"
RRN = "countries/Ximalcotlan.txt"
RRO = "countries/Xiahuacan.txt"
RRP = "countries/Ziahuatenejo.txt"
RRQ = "countries/Iztapan.txt"
RRR = "countries/Xiuhtlan.txt"
RRS = "countries/Xolotlan.txt"
RRT = "countries/Apancalecan.txt"
RRU = "countries/Tepochtlan.txt"
RRV = "countries/Huitztlan.txt"
RRW = "countries/Huehuepiaztla.txt"
RRX = "countries/Tecomatlan.txt"
RRY = "countries/Piaztlan.txt"
RRZ = "countries/Tuzantlan.txt"
SSA = "countries/Chinantla.txt"
SSB = "countries/Ilamacinco.txt"
SSC = "countries/Mixquitepec.txt"
SSD = "countries/Eloixtlahuacan.txt"
SSE = "countries/HueyAcatlan.txt"
SSF = "countries/Xayacatlan.txt"
SSG = "countries/Petlalcinco.txt"
SSH = "countries/Chila.txt"
SSI = "countries/Ycxitlan.txt"
SSJ = "countries/Chietlan.txt"
SSK = "countries/Ytzucan.txt"
SSL = "countries/Quauhquechollan.txt"
SSM = "countries/Nacochtlan.txt"
SSN = "countries/Epatlan.txt"
SSO = "countries/Teonochtitlan.txt"
SSP = "countries/Teopantlan.txt"
SSQ = "countries/Ahuatlan.txt"
SSR = "countries/Tejaluca.txt"
SSS = "countries/Coatitlanapa.txt"
SST = "countries/Coatzinco.txt"
SSU = "countries/Quatlatlauhcan.txt"
SSV = "countries/HuehuetlanTepeacac.txt"
SSW = "countries/TepexicTepeacac.txt"
SSX = "countries/Tecalco.txt"
SSY = "countries/Quauhtinchan.txt"
SSZ = "countries/Tepeacac.txt"
TTA = "countries/AcatzincoTepeacac.txt"
TTB = "countries/Tecamachalco.txt"
TTC = "countries/Quechulac.txt"
TTD = "countries/TetenancoTepeacac.txt"
TTE = "countries/Atlixco.txt"
TTF = "countries/Tiaguismanalco.txt"
TTG = "countries/Aculcinco.txt"
TTH = "countries/Matatlan.txt"
TTI = "countries/Ahuilizapan.txt"
TTJ = "countries/Atzacan.txt"
TTK = "countries/Chocaman.txt"
TTL = "countries/Ytzteyocan.txt"
TTM = "countries/CuezcomatlYacac.txt"
TTN = "countries/Tochconco.txt"
TTO = "countries/Ixhuatlan.txt"
TTP = "countries/Quauhtochco.txt"
TTQ = "countries/Chichiquila.txt"
TTR = "countries/Tototlan.txt"
TTS = "countries/Quimixtlan.txt"
TTT = "countries/OhuapanQuauhtochco.txt"
TTU = "countries/Calcahualco.txt"
TTV = "countries/Tenampa.txt"
TTW = "countries/Xalcomulco.txt"
TTX = "countries/Yzhuacan.txt"
TTY = "countries/Xicochimalco.txt"
TTZ = "countries/CoatepecXalapa.txt"
UUA = "countries/Xalapa.txt"
UUB = "countries/Atezcac.txt"
UUC = "countries/Chiguacoatlan.txt"
UUD = "countries/Chiltoyac.txt"
UUE = "countries/Maxtlatlan.txt"
UUF = "countries/Almoloncan.txt"
UUG = "countries/XilotepecXalapa.txt"
UUH = "countries/Quaquauhcintla.txt"
UUI = "countries/TlacolulaXalapa.txt"
UUJ = "countries/Chepultepec.txt"
UUK = "countries/Naolinco.txt"
UUL = "countries/Tepetlan.txt"
UUM = "countries/AcatlanXalapa.txt"
UUN = "countries/Miahuatlan.txt"
UUO = "countries/Chiconquiahco.txt"
UUP = "countries/TenochtitlanXalapa.txt"
UUQ = "countries/Chicuacentepec.txt"
UUR = "countries/Atocpan.txt"
UUS = "countries/Tizapantzinco.txt"
UUT = "countries/Quiahuiztlan.txt"
UUU = "countries/Cempoallan.txt"
UUV = "countries/Colipa.txt"
UUW = "countries/Misantla.txt"
UUX = "countries/Poztectlan.txt"
UUY = "countries/Nautla.txt"
UUZ = "countries/Xiuhtetelco.txt"
VVA = "countries/Hueytamalco.txt"
VVB = "countries/Tecuitlan.txt"
VVC = "countries/Chignautla.txt"
VVD = "countries/Mexcalcuauhtla.txt"
VVE = "countries/Atenco.txt"
VVF = "countries/Tlatlauhquitepec.txt"
VVG = "countries/Zacapoaxtla.txt"
VVH = "countries/AhuacatlanTlatlauhquitepec.txt"
VVI = "countries/Nautzontla.txt"
VVJ = "countries/Yayauhquitlalapan.txt"
VVK = "countries/Ayotochco.txt"
VVL = "countries/Zozocolco.txt"
VVM = "countries/Xonotla.txt"
VVN = "countries/Ocelonacaztla.txt"
VVO = "countries/Caxuacan.txt"
VVP = "countries/Ytztepec.txt"
VVQ = "countries/Huehuetla.txt"
VVR = "countries/Olintla.txt"
VVS = "countries/Uitzila.txt"
VVT = "countries/Zongozotlan.txt"
VVU = "countries/Teotlalpan.txt"
VVV = "countries/CoatepecTlatlauhquitepec.txt"
VVW = "countries/Camoquauhtla.txt"
VVX = "countries/Calpulapan.txt"
VVY = "countries/Tetela.txt"
VVZ = "countries/Cuauhtempan.txt"
WWA = "countries/Chignahuapan.txt"
WWB = "countries/TenancoTlapacoyan.txt"
WWC = "countries/Acacacatlan.txt"
WWD = "countries/Xiloxochitlan.txt"
WWE = "countries/Tepecintla.txt"
WWF = "countries/AhuacatlanTlapacoyan.txt"
WWG = "countries/Tepanco.txt"
WWH = "countries/Amixtlan.txt"
WWI = "countries/Xochiquauhtitlan.txt"
WWJ = "countries/Tlapacoyan.txt"
WWK = "countries/Zoncolica.txt"
WWL = "countries/Teociocan.txt"
WWM = "countries/Otopa.txt"
WWN = "countries/Cuetlaxtlan.txt"
WWO = "countries/MictlanQuauhtla.txt"
WWP = "countries/Tuzapan.txt"
WWQ = "countries/Coatzintlan.txt"
WWR = "countries/Papantla.txt"
WWS = "countries/Macotla.txt"
WWT = "countries/Miahuaapan.txt"
WWU = "countries/Cihuateopan.txt"
WWV = "countries/OcelotepecTochpan.txt"
WWW = "countries/Tlalticapan.txt"
WWX = "countries/Tochpan.txt"
WWY = "countries/MictlanTochpan.txt"
WWZ = "countries/Tecapotitlan.txt"
XXA = "countries/Huitzilac.txt"
XXB = "countries/Atlan.txt"
XXC = "countries/Pantepec.txt"
XXD = "countries/Metlaltoyuca.txt"
XXE = "countries/Puxutlan.txt"
XXF = "countries/Yoaltepec.txt"
XXG = "countries/Ehuacalco.txt"
XXH = "countries/Patlanalan.txt"
XXI = "countries/Tzilacaapan.txt"
XXJ = "countries/Igualtepec.txt"
XXK = "countries/Ycpatepec.txt"
XXL = "countries/Tecomaixtlahuacan.txt"
XXM = "countries/Ayoxochiquilazala.txt"
XXN = "countries/TlacotepecTlachquiauhco.txt"
XXO = "countries/Mixtepec.txt"
XXP = "countries/Tlachquiauhco.txt"
XXQ = "countries/Achiotlan.txt"
XXR = "countries/MictlanTlachquiauhco.txt"
XXS = "countries/Tamacolan.txt"
XXT = "countries/Xaltepec.txt"
XXU = "countries/CocolanCoayxtlahuacan.txt"
XXV = "countries/Nochiztlan.txt"
XXW = "countries/Yancuitlan.txt"
XAA = "countries/Tepuzcululan.txt"
XXY = "countries/Cayultepec.txt"
XXZ = "countries/Texopan.txt"
YYA = "countries/Tamacolapan.txt"
YYB = "countries/Coayxtlahuacan.txt"
YYC = "countries/Atlatuacca.txt"
YYD = "countries/MalinaltepecCoayxtlahuacan.txt"
YYE = "countries/Coaxomulco.txt"
YYF = "countries/Tepeucila.txt"
YYG = "countries/Cuicatlan.txt"
YYH = "countries/Papaloticpac.txt"
YYI = "countries/Yoloxonecuilan.txt"
YYJ = "countries/Atepec.txt"
YYK = "countries/Tecuicuilco.txt"
YYL = "countries/Xaltianquizco.txt"
YYM = "countries/Itztitlan.txt"
YYN = "countries/Coquiapan.txt"
YYO = "countries/Ixtepexi.txt"
YYP = "countries/TototepecTochtepec.txt"
YYQ = "countries/Ucila.txt"
YYR = "countries/Chinantlan.txt"
YYS = "countries/Puctlan.txt"
YYT = "countries/Ayotzintepec.txt"
YYU = "countries/Mixtlan.txt"
YYV = "countries/Oxitlan.txt"
YYW = "countries/Teotlilan.txt"
YYX = "countries/Tochtepec.txt"
YYZ = "countries/Otlatitlan.txt"
ZZA = "countries/Toztlan.txt"
ZZB = "countries/Cocamaloapan.txt"
ZZC = "countries/Yxmatlatlan.txt"
ZZD = "countries/Tlacotlalpan.txt"
ZZE = "countries/PuctlanTochtepecMictlampa.txt"
ZZF = "countries/AyotlanXoconochco.txt"
ZZG = "countries/Coyoacan.txt"
ZZH = "countries/Macatlan.txt"
ZZI = "countries/HuehuetlanXoconochco.txt"
ZZJ = "countries/Huiztlan.txt"
ZZK = "countries/Acapetlaclan.txt"
ZZL = "countries/Xoconochco.txt"
ZZM = "countries/Mapachtepec.txt"
ZZN = "countries/Chacaya.txt"
ZZO = "countries/Xepoyom.txt"
ZZP = "countries/Chejiyu.txt"
ZZQ = "countries/Toliman.txt"
ZZR = "countries/Palopo.txt"
ZZS = "countries/Ajachel.txt"
ZZT = "countries/Tzolola.txt"
ZZU = "countries/Panpati.txt"
ZZV = "countries/PayanChocol.txt"
ZZW = "countries/Chupalo.txt"
ZZX = "countries/ChiTzununChoy.txt"
ZZY = "countries/Chiya.txt"
ZZZ = "countries/CotzIj.txt"
A01 = "countries/Xeoj.txt"
A02 = "countries/Nagualapa.txt"
A03 = "countries/Quioj.txt"
A04 = "countries/Malaj.txt"
A05 = "countries/Panyevar.txt"
A06 = "countries/Patulul.txt"
A07 = "countries/Pochuta.txt"
A08 = "countries/Chicochin.txt"
A09 = "countries/Pacoan.txt"
A10 = "countries/Iximche.txt"
A11 = "countries/Nahuallan.txt"
A12 = "countries/Cacahuatepec.txt"
A13 = "countries/XiquipilcoYopitzinco.txt"
A14 = "countries/Xaltzapotlan.txt"
A15 = "countries/Tezcatlan.txt"
A16 = "countries/XaltianquizcoYopitzinco.txt"
A17 = "countries/Omitlan.txt"
A18 = "countries/Aneneculco.txt"
A19 = "countries/Citlaltomahuac.txt"
A20 = "countries/Tepetixtlan.txt"
A21 = "countries/Yopitzinco.txt"
A22 = "countries/Metztitlan.txt"
A23 = "countries/Xihuico.txt"
A24 = "countries/Tlatemalco.txt"
A25 = "countries/Itzacapan.txt"
A26 = "countries/Elaxochitlan.txt"
A27 = "countries/Tlachinoltipac.txt"
A28 = "countries/Mollanco.txt"
A29 = "countries/Tlahuelampa.txt"
A30 = "countries/Ilamatlan.txt"
A31 = "countries/Huazalinco.txt"
A32 = "countries/AtotonilcoMictlampa.txt"
A33 = "countries/Quauhquecaloyan.txt"
A34 = "countries/HueyapanAtotonilco.txt"
A35 = "countries/AcatlanAtotonilco.txt"
A36 = "countries/Tolancinco.txt"
A37 = "countries/HueyapanIhuitztlampa.txt"
A38 = "countries/Acaxochitlan.txt"
A39 = "countries/Zacacuautla.txt"
A40 = "countries/Tlaxpanaloya.txt"
A41 = "countries/Heloxochitlan.txt"
A42 = "countries/Quacetlan.txt"
A43 = "countries/Cuauhchinanco.txt"
A44 = "countries/Cuachahuantla.txt"
A45 = "countries/Copila.txt"
A46 = "countries/Xicotepec.txt"
A47 = "countries/Xilocuautla.txt"
A48 = "countries/Xaltepuxtla.txt"
A49 = "countries/Xochinamacatlan.txt"
A50 = "countries/Chicahuastla.txt"
A51 = "countries/Chiconquautla.txt"
A52 = "countries/Hueyacocotlan.txt"
A53 = "countries/TezcatepecMetztitlan.txt"
A54 = "countries/Cuauhtecomaco.txt"
A55 = "countries/Tezcateopan.txt"
A56 = "countries/Tzacualpan.txt"
A57 = "countries/HueyTototepec.txt"
A58 = "countries/TenancoTototepec.txt"
A59 = "countries/Temazcalapa.txt"
A60 = "countries/TlachcoTototepec.txt"
A61 = "countries/Achioquauhtlan.txt"
A62 = "countries/Molanco.txt"
A63 = "countries/Chicontepec.txt"
A64 = "countries/Tamapachco.txt"
A65 = "countries/Cozcatecuhtlan.txt"
A66 = "countries/Tzicoac.txt"
A67 = "countries/Ychcatlan.txt"
A68 = "countries/Tianguis.txt"
A69 = "countries/Tehuatlan.txt"
A70 = "countries/Xiquitla.txt"
A71 = "countries/HuexotlaMictlampa.txt"
A72 = "countries/Toncocahuelan.txt"
A73 = "countries/Cozcatlan.txt"
A74 = "countries/Oxitipan.txt"
A75 = "countries/Ocotelulco.txt"
A76 = "countries/Tizatlan.txt"
A77 = "countries/Tepeticpac.txt"
A78 = "countries/Quiahuixtlan.txt"
A79 = "countries/Tzompantzinco.txt"
A80 = "countries/Cuauhmantla.txt"
A81 = "countries/Tecoac.txt"
A82 = "countries/Quimichocan.txt"
A83 = "countries/Texcallac.txt"
A84 = "countries/Atlancatepec.txt"
A85 = "countries/Heotlipan.txt"
A86 = "countries/Tlalpechco.txt"
A87 = "countries/Iztaccuixtla.txt"
A88 = "countries/Huitzilhuacan.txt"
A89 = "countries/ChiauhtlaHuexotzinco.txt"
A90 = "countries/Tepetlachco.txt"
A91 = "countries/Tepetzinco.txt"
A92 = "countries/Tetzmoliuhcan.txt"
A93 = "countries/Teotlatzin.txt"
A94 = "countries/Zecalacoyocan.txt"
A95 = "countries/Huexotzinco.txt"
A96 = "countries/Calpan.txt"
A97 = "countries/Tochmilco.txt"
A98 = "countries/AtlixcoHuexotzinco.txt"
A99 = "countries/Cholula.txt"
B01 = "countries/Totimehuacan.txt"
B02 = "countries/Tliltepec.txt"
B03 = "countries/HuehueIchocayan.txt"
B04 = "countries/Coliuhcan.txt"
B05 = "countries/Zacatlan.txt"
B06 = "countries/Tetella.txt"
B07 = "countries/Tonalapan.txt"
B08 = "countries/TlachcoTepeticpac.txt"
B09 = "countries/Itzacimaxtitlan.txt"
B10 = "countries/Calpullac.txt"
B11 = "countries/Tlaxichco.txt"
B12 = "countries/Toltzinco.txt"
B13 = "countries/Tecuanipa.txt"
B14 = "countries/TetellaChalco.txt"
B15 = "countries/Yacapixtla.txt"
B16 = "countries/Mazaapan.txt"
B17 = "countries/Calpullalpan.txt"
B18 = "countries/Zacatelco.txt"
B19 = "countries/Xicotzinco.txt"
B20 = "countries/Mazatecochco.txt"
B21 = "countries/Temazcalapan.txt"
B22 = "countries/TezontepecTlauhcopa.txt"
B23 = "countries/Tlaquilpan.txt"
B24 = "countries/Acayucan.txt"
B25 = "countries/Cempoala.txt"
B26 = "countries/Epazoyucan.txt"
B27 = "countries/Tepeapulco.txt"
B28 = "countries/Apan.txt"
B29 = "countries/Ahuatepec.txt"
B30 = "countries/Tututepec.txt"
B31 = "countries/Cacalotepec.txt"
B32 = "countries/Manialtepec.txt"
B33 = "countries/Tonameca.txt"
B34 = "countries/Pochutla.txt"
B35 = "countries/Coyula.txt"
B36 = "countries/Huatulco.txt"
B37 = "countries/Astata.txt"
B38 = "countries/Huamelula.txt"
B39 = "countries/Topiltepec.txt"
B40 = "countries/OcelotepecTututepec.txt"
B41 = "countries/Xanica.txt"
B42 = "countries/Loxicha.txt"
B43 = "countries/Suchixtepec.txt"
B44 = "countries/MixtepecTututepec.txt"
B45 = "countries/Juquila.txt"
B46 = "countries/Panixtlahuaca.txt"
B47 = "countries/Tataltepec.txt"
B48 = "countries/Zenzontepec.txt"
B49 = "countries/Amoltepec.txt"
B50 = "countries/Jamiltepec.txt"
B51 = "countries/Huaxpaltepec.txt"
B52 = "countries/Juchatengo.txt"
B53 = "countries/Pinotepa.txt"
B54 = "countries/Jicayan.txt"
B55 = "countries/Ixtayutla.txt"
B56 = "countries/ZacatepecTututepec.txt"
B57 = "countries/Huajintepec.txt"
B58 = "countries/Comitlan.txt"
B59 = "countries/Toltepec.txt"
B60 = "countries/Zaachila.txt"
B61 = "countries/Cuilapan.txt"
B62 = "countries/Huaxacac.txt"
B63 = "countries/Quauhxilotitlan.txt"
B64 = "countries/Etlan.txt"
B65 = "countries/Camotlan.txt"
B66 = "countries/Tlaliztacan.txt"
B67 = "countries/TeticpacCoyolapan.txt"
B68 = "countries/Tlalcuechahueyan.txt"
B69 = "countries/Macuilxochic.txt"
B70 = "countries/Octlan.txt"
B71 = "countries/Jalieza.txt"
B72 = "countries/Tilquiapan.txt"
B73 = "countries/Taviche.txt"
B74 = "countries/Lachiqalla.txt"
B75 = "countries/Chichicapan.txt"
B76 = "countries/MatatlanTeozapotlan.txt"
B77 = "countries/Yagul.txt"
B78 = "countries/MictlanTeozapotlan.txt"
B79 = "countries/Quellabilla.txt"
B80 = "countries/Teozacualco.txt"
B81 = "countries/Itzquintepec.txt"
B82 = "countries/Quauhxiloticpac.txt"
B83 = "countries/Huiztepec.txt"
B84 = "countries/Totomachapan.txt"
B85 = "countries/XilotepecTeozacualco.txt"
B86 = "countries/Cencontepec.txt"
B87 = "countries/HueyMiahuatlan.txt"
B88 = "countries/Cuixtlan.txt"
B89 = "countries/CoatlanMiahuatlan.txt"
B90 = "countries/Tamazola.txt"
B91 = "countries/Mitlatongo.txt"
B92 = "countries/Tilantongo.txt"
B93 = "countries/Yucane.txt"
B94 = "countries/Jaltepec.txt"
B95 = "countries/Sosola.txt"
B96 = "countries/Achuitla.txt"
B97 = "countries/Atoyaquillo.txt"
B98 = "countries/Tlaxiaco.txt"
B99 = "countries/Soyaltepec.txt"
F01 = "countries/Tejupan.txt"
F02 = "countries/Apoala.txt"
F03 = "countries/Huautla.txt"
F04 = "countries/Huilotepec.txt"
F05 = "countries/Tehuantepec.txt"
F06 = "countries/Jalapa.txt"
F07 = "countries/Nejapa.txt"
F08 = "countries/Tequisistlan.txt"
F09 = "countries/Tlacolulita.txt"
F10 = "countries/Quiegolana.txt"
F11 = "countries/Lachiguiri.txt"
F12 = "countries/NejapaTeozapotlan.txt"
F13 = "countries/Sola.txt"
F14 = "countries/Amatengo.txt"
F15 = "countries/Zabache.txt"
F16 = "countries/Texmulucan.txt"
F17 = "countries/Yolotepec.txt"
F18 = "countries/XochitlanTehuantepec.txt"
F19 = "countries/AmatitlanTehuantepec.txt"
F20 = "countries/CamotlanTehuantepec.txt"
F21 = "countries/IxhuatlanTehuantepec.txt"
F22 = "countries/Tapanatepec.txt"
F23 = "countries/TonalaTehuantepec.txt"
F24 = "countries/Tamaulipas.txt"
F25 = "countries/Chocohuitl.txt"
F26 = "countries/Qumarcaaj.txt"
F27 = "countries/Jacawitz.txt"
F28 = "countries/Tinamit.txt"
F29 = "countries/Xojbaquiej.txt"
F30 = "countries/Chiawar.txt"
F31 = "countries/WarabalKalel.txt"
F32 = "countries/Pokoba.txt"
F33 = "countries/Cabrakan.txt"
F34 = "countries/Uquin.txt"
F35 = "countries/Chiaj.txt"
F36 = "countries/Momostenango.txt"
F37 = "countries/Ilotenango.txt"
F38 = "countries/Ilocab.txt"
F39 = "countries/Zakabaja.txt"
F40 = "countries/Chujuyup.txt"
F41 = "countries/Joyabaj.txt"
F42 = "countries/Pachalum.txt"
F43 = "countries/Lemoa.txt"
F44 = "countries/Huacan.txt"
F45 = "countries/Patzak.txt"
F46 = "countries/Paraxone.txt"
F47 = "countries/Chirijuyu.txt"
F48 = "countries/Comalapa.txt"
F49 = "countries/Poaquil.txt"
F50 = "countries/Patzicia.txt"
F51 = "countries/ChuviaMikiha.txt"
F52 = "countries/Sijia.txt"
F53 = "countries/XochO.txt"
F54 = "countries/MikIna.txt"
F55 = "countries/ChuwaTzAk.txt"
F56 = "countries/Xecul.txt"
F57 = "countries/Xelaju.txt"
F58 = "countries/Chuitinamit.txt"
F59 = "countries/Xetulul.txt"
F60 = "countries/Samayac.txt"
F61 = "countries/Cakolquiej.txt"
F62 = "countries/Retalhuleuh.txt"
F63 = "countries/Nahuatan.txt"
F64 = "countries/Tzameneb.txt"
F65 = "countries/Cawinal.txt"
F66 = "countries/RabinalChuitinamit.txt"
F67 = "countries/Cahyup.txt"
F68 = "countries/TzAlAmja.txt"
F69 = "countries/Concul.txt"
F70 = "countries/Tuncaj.txt"
F71 = "countries/Chuacusito.txt"
F72 = "countries/Sacapulas.txt"
F73 = "countries/Chixoy.txt"
F74 = "countries/AkAab.txt"
F75 = "countries/Chamac.txt"
F76 = "countries/Balamija.txt"
F77 = "countries/Cunen.txt"
F78 = "countries/Cotzal.txt"
F79 = "countries/Chajul.txt"
F80 = "countries/Nebaj.txt"
F81 = "countries/Vicaveval.txt"
F82 = "countries/TzalamjaN.txt"
F83 = "countries/Quilaja.txt"
F84 = "countries/Malacatan.txt"
F85 = "countries/Zaculeu.txt"
F86 = "countries/Sipacapa.txt"
F87 = "countries/ItzAlAmja.txt"
F88 = "countries/Chuisac.txt"
F89 = "countries/ChitakZak.txt"
F90 = "countries/Jilotepec.txt"
F91 = "countries/Chuabaj.txt"
F92 = "countries/Sacul.txt"
F93 = "countries/Cipres.txt"
F94 = "countries/Pistun.txt"
F95 = "countries/Chuarrancho.txt"
F96 = "countries/Chimaltenango.txt"
F97 = "countries/Itzapa.txt"
F98 = "countries/Yepocapa.txt"
F99 = "countries/Cotzumalhuapa.txt"
G01 = "countries/Ayampuc.txt"
G02 = "countries/Chinautla.txt"
G03 = "countries/Petapa.txt"
G04 = "countries/MalacatanXoconochco.txt"
G05 = "countries/Pajapita.txt"
G06 = "countries/Chiquirines.txt"
G07 = "countries/Nahualate.txt"
G08 = "countries/Cuyotenango.txt"
G09 = "countries/Retalhuleu.txt"
G10 = "countries/Tiquisate.txt"
G11 = "countries/TolimanPipil.txt"
G12 = "countries/Champerica.txt"
G13 = "countries/Chiquistepec.txt"
G14 = "countries/Tilapa.txt"
G15 = "countries/Pacaya.txt"
G16 = "countries/MixtlanPipil.txt"
G17 = "countries/MiahuatlanPipil.txt"
G18 = "countries/Texcuaco.txt"
G19 = "countries/Zacualpa.txt"
G20 = "countries/Ichancueque.txt"
G21 = "countries/Tecuantepec.txt"
G22 = "countries/Chipilapa.txt"
G23 = "countries/Utazinco.txt"
G24 = "countries/Amayuca.txt"
G25 = "countries/Cacaotlan.txt"
G26 = "countries/Masahuat.txt"
G27 = "countries/ItzquintepecPipil.txt"
G28 = "countries/MalacatepecPipil.txt"
G29 = "countries/Iztapa.txt"
G30 = "countries/Chiquiotla.txt"
G31 = "countries/Ixhuatan.txt"
G32 = "countries/Jumaytepec.txt"
G33 = "countries/Jalpatacua.txt"
G34 = "countries/Comapa.txt"
G35 = "countries/Mopicalco.txt"
G36 = "countries/Mita.txt"
G37 = "countries/Langui.txt"
G38 = "countries/Metapan.txt"
G39 = "countries/Uxaca.txt"
G40 = "countries/Tecomatan.txt"
G41 = "countries/Tequezistepec.txt"
G42 = "countries/MasahuatTlauhcopa.txt"
G43 = "countries/Atempa.txt"
G44 = "countries/Atiquizaya.txt"
G45 = "countries/Tacuba.txt"
G46 = "countries/Acatepec.txt"
G47 = "countries/Chalchuapa.txt"
G48 = "countries/Ahuachapan.txt"
G49 = "countries/Ataco.txt"
G50 = "countries/Apaneca.txt"
G51 = "countries/Juxutla.txt"
G52 = "countries/Juayua.txt"
G53 = "countries/Quetzalcoatitlan.txt"
G54 = "countries/Nahuizalco.txt"
G55 = "countries/Naolenco.txt"
G56 = "countries/Tacuscalco.txt"
G57 = "countries/Acaxutla.txt"
G58 = "countries/Izalco.txt"
G59 = "countries/Caluco.txt"
G60 = "countries/TonalaPipil.txt"
G61 = "countries/Cacaluta.txt"
G62 = "countries/Cuemoco.txt"
G63 = "countries/CoatepecPipil.txt"
G64 = "countries/Cicuatecuacan.txt"
G65 = "countries/Tacachio.txt"
G66 = "countries/Tepzacua.txt"
G67 = "countries/Opico.txt"
G68 = "countries/Ateo.txt"
G69 = "countries/Coyo.txt"
G70 = "countries/Jayaquetepec.txt"
G71 = "countries/Cuisnahuat.txt"
G72 = "countries/Zapotan.txt"
G73 = "countries/Teotepec.txt"
G74 = "countries/Jicalapa.txt"
G75 = "countries/Chilteupan.txt"
G76 = "countries/Tamanique.txt"
G77 = "countries/Comasacua.txt"
G78 = "countries/Talnitepec.txt"
G79 = "countries/Cuscatlan.txt"
G80 = "countries/Izucar.txt"
G81 = "countries/Zincantan.txt"
G82 = "countries/Xalozinacua.txt"
G83 = "countries/Tequepa.txt"
G84 = "countries/Cuyultitan.txt"
G85 = "countries/Olocuilta.txt"
G86 = "countries/Chinameca.txt"
G87 = "countries/Panchitmalco.txt"
G88 = "countries/Tequezacuanco.txt"
G89 = "countries/Soyapanco.txt"
G90 = "countries/Xilopanco.txt"
G91 = "countries/Ayotuxtepec.txt"
G92 = "countries/Quetzaltepec.txt"
G93 = "countries/NejapaPipil.txt"
G94 = "countries/Apocopa.txt"
G95 = "countries/Tonacatepec.txt"
G96 = "countries/Cuazapa.txt"
G97 = "countries/Zicacalco.txt"
G98 = "countries/Chalcalinco.txt"
G99 = "countries/Suchitoto.txt"
H01 = "countries/TenancoPipil.txt"
H02 = "countries/Montepec.txt"
H03 = "countries/Perulapan.txt"
H04 = "countries/Huiziltepec.txt"
H05 = "countries/Tejutepec.txt"
H06 = "countries/Cuxutepec.txt"
H07 = "countries/Tepezonte.txt"
H08 = "countries/Chiconcoa.txt"
H09 = "countries/IxtepecPipil.txt"
H10 = "countries/Tecoluca.txt"
H11 = "countries/Tecoluzelo.txt"
H12 = "countries/Zacatecoluca.txt"
H13 = "countries/Nonualco.txt"
H14 = "countries/Zoquitlan.txt"
H15 = "countries/Sisal.txt"
H16 = "countries/Boxcouoh.txt"
H17 = "countries/Celestun.txt"
H18 = "countries/Nimum.txt"
H19 = "countries/Calin.txt"
H20 = "countries/Hunucma.txt"
H21 = "countries/Ucu.txt"
H22 = "countries/Tetis.txt"
H23 = "countries/Calakxan.txt"
H24 = "countries/Kinchil.txt"
H25 = "countries/Tzeme.txt"
H26 = "countries/Samahil.txt"
H27 = "countries/Dzibikak.txt"
H28 = "countries/Bolonpoxche.txt"
H29 = "countries/Sinhunchen.txt"
H30 = "countries/Chochola.txt"
H31 = "countries/Kapoma.txt"
H32 = "countries/Paraiso.txt"
H33 = "countries/Maxcanu.txt"
H34 = "countries/Tuchican.txt"
H35 = "countries/Acansip.txt"
H36 = "countries/Yaltan.txt"
H37 = "countries/Hinal.txt"
H38 = "countries/Siho.txt"
H39 = "countries/Chepeda.txt"
H40 = "countries/Tzemezakal.txt"
H41 = "countries/Becal.txt"
H42 = "countries/Numkini.txt"
H43 = "countries/Cumpich.txt"
H44 = "countries/Pocboc.txt"
H45 = "countries/Pokmuch.txt"
H46 = "countries/Tahnab.txt"
H47 = "countries/Tikumche.txt"
H48 = "countries/Tinum.txt"
H49 = "countries/Xtuul.txt"
H50 = "countries/Caucel.txt"
H51 = "countries/Dzibikal.txt"
H52 = "countries/Tixbecya.txt"
H53 = "countries/Tiho.txt"
H54 = "countries/Kanalsin.txt"
H55 = "countries/Timucuy.txt"
H56 = "countries/Tecoh.txt"
H57 = "countries/Acanceh.txt"
H58 = "countries/Seye.txt"
H59 = "countries/Tahmek.txt"
H60 = "countries/Hoctun.txt"
H61 = "countries/Hocaba.txt"
H62 = "countries/Yocchel.txt"
H63 = "countries/Tzanlahcat.txt"
H64 = "countries/Huhi.txt"
H65 = "countries/Balche.txt"
H66 = "countries/Humun.txt"
H67 = "countries/Cusama.txt"
H68 = "countries/Chelen.txt"
H69 = "countries/Chicxulub.txt"
H70 = "countries/Telchac.txt"
H71 = "countries/Maxtunil.txt"
H72 = "countries/Chablekal.txt"
H73 = "countries/Chubulna.txt"
H74 = "countries/Itzamna.txt"
H75 = "countries/Sicipach.txt"
H76 = "countries/Cumkal.txt"
H77 = "countries/Ixil.txt"
H78 = "countries/Tixpeual.txt"
H79 = "countries/Nolo.txt"
H80 = "countries/Yaxkukul.txt"
H81 = "countries/Baca.txt"
H82 = "countries/Ekmul.txt"
H83 = "countries/Cacalchen.txt"
H84 = "countries/Euan.txt"
H85 = "countries/Muxupib.txt"
H86 = "countries/Mutul.txt"
H87 = "countries/Dzemul.txt"
H88 = "countries/Ucuyi.txt"
H89 = "countries/Suma.txt"
H90 = "countries/Bokoba.txt"
H91 = "countries/Sinanche.txt"
H92 = "countries/Yobain.txt"
H93 = "countries/Dzidzantun.txt"
H94 = "countries/Dzilam.txt"
H95 = "countries/Dzonotlu.txt"
H96 = "countries/Cansahcab.txt"
H97 = "countries/Temax.txt"
H98 = "countries/Buctzotz.txt"
H99 = "countries/Nohyaxche.txt"
I01 = "countries/Opichen.txt"
I02 = "countries/Dzoncauich.txt"
I03 = "countries/Teya.txt"
I04 = "countries/Tepakan.txt"
I05 = "countries/Tekal.txt"
I06 = "countries/Tekanto.txt"
I07 = "countries/Kimbila.txt"
I08 = "countries/Izamal.txt"
I09 = "countries/Sitilpech.txt"
I10 = "countries/Dzudzal.txt"
I11 = "countries/Kantunil.txt"
I12 = "countries/Xanabal.txt"
I13 = "countries/Tibolon.txt"
I14 = "countries/Sotuta.txt"
I15 = "countries/Yaxa.txt"
I16 = "countries/Tekom.txt"
I17 = "countries/Cantamayec.txt"
I18 = "countries/Nenela.txt"
I19 = "countries/Tixxcacaltuyu.txt"
I20 = "countries/Tacchebilchen.txt"
I21 = "countries/Mopila.txt"
I22 = "countries/Sahcaba.txt"
I23 = "countries/Yaxcaba.txt"
I24 = "countries/Tabi.txt"
I25 = "countries/Chunyaxnic.txt"
I26 = "countries/Panabhaa.txt"
I27 = "countries/Tilzilz.txt"
I28 = "countries/Yakchac.txt"
I29 = "countries/Kikil.txt"
I30 = "countries/Tzucila.txt"
I31 = "countries/Titzimin.txt"
I32 = "countries/Tzucop.txt"
I33 = "countries/Sodzil.txt"
I34 = "countries/Tahcab.txt"
I35 = "countries/Calotmul.txt"
I36 = "countries/Tixppitah.txt"
I37 = "countries/Pip.txt"
I38 = "countries/Tixcacalcupul.txt"
I39 = "countries/Tidzonot.txt"
I40 = "countries/Tunkas.txt"
I41 = "countries/Dzitas.txt"
I42 = "countries/Ekbalam.txt"
I43 = "countries/Hunabku.txt"
I44 = "countries/Nabalam.txt"
I45 = "countries/Xocenpich.txt"
I46 = "countries/Ppiste.txt"
I47 = "countries/ChichenItza.txt"
I48 = "countries/Tioy.txt"
I49 = "countries/Ticocay.txt"
I50 = "countries/SisalCupul.txt"
I51 = "countries/TinumCupul.txt"
I52 = "countries/Kaua.txt"
I53 = "countries/Timoson.txt"
I54 = "countries/Yalcoba.txt"
I55 = "countries/Uayumhu.txt"
I56 = "countries/Cuncunul.txt"
I57 = "countries/Tixcacal.txt"
I58 = "countries/Xocen.txt"
I59 = "countries/Chechemila.txt"
I60 = "countries/SisalSaci.txt"
I61 = "countries/Tiozoc.txt"
I62 = "countries/Tikuch.txt"
I63 = "countries/Tixualahtun.txt"
I64 = "countries/Tases.txt"
I65 = "countries/Chancenote.txt"
I66 = "countries/Tixcancal.txt"
I67 = "countries/Holcoben.txt"
I68 = "countries/Emal.txt"
I69 = "countries/Loche.txt"
I70 = "countries/Dzonotake.txt"
I71 = "countries/Sisha.txt"
I72 = "countries/Ake.txt"
I73 = "countries/Chakantzimin.txt"
I74 = "countries/Chauaca.txt"
I75 = "countries/Sinsimato.txt"
I76 = "countries/Sacboh.txt"
I77 = "countries/Yalahau.txt"
I78 = "countries/Labcah.txt"
I79 = "countries/Kantunilkin.txt"
I80 = "countries/Chiquila.txt"
I81 = "countries/Holbox.txt"
I82 = "countries/Conil.txt"
I83 = "countries/Homhom.txt"
I84 = "countries/Ecab.txt"
I85 = "countries/Meco.txt"
I86 = "countries/Cancun.txt"
I87 = "countries/Muchi.txt"
I88 = "countries/Pole.txt"
I89 = "countries/Mulchi.txt"
I90 = "countries/Xcaret.txt"
I91 = "countries/Xalha.txt"
I92 = "countries/Tancah.txt"
I93 = "countries/Tzama.txt"
I94 = "countries/Cadral.txt"
I95 = "countries/Xamancab.txt"
I96 = "countries/Mayapan.txt"
I97 = "countries/Tichac.txt"
I98 = "countries/Yacman.txt"
I99 = "countries/Yaxnic.txt"
J01 = "countries/Tisolche.txt"
J02 = "countries/Tipikal.txt"
J03 = "countries/Chenkeken.txt"
J04 = "countries/Muna.txt"
J05 = "countries/Sacalum.txt"
J06 = "countries/Chapab.txt"
J07 = "countries/Mama.txt"
J08 = "countries/Yaxumha.txt"
J09 = "countries/Ticul.txt"
J10 = "countries/Dzan.txt"
J11 = "countries/Mani.txt"
J12 = "countries/TipikalXiu.txt"
J13 = "countries/Chumayel.txt"
J14 = "countries/Chulul.txt"
J15 = "countries/Teabo.txt"
J16 = "countries/Panabchan.txt"
J17 = "countries/Ppencuyut.txt"
J18 = "countries/Tixmeuac.txt"
J19 = "countries/Tahoziu.txt"
J20 = "countries/Akil.txt"
J21 = "countries/Tekak.txt"
J22 = "countries/Peto.txt"
J23 = "countries/Tzuccacab.txt"
J24 = "countries/Sabachcalal.txt"
J25 = "countries/Dzonalchel.txt"
J26 = "countries/Tzitzila.txt"
J27 = "countries/Uxmal.txt"
J28 = "countries/Nohcacab.txt"
J29 = "countries/Xul.txt"
J30 = "countries/Yothholin.txt"
J31 = "countries/Oxkutzcab.txt"
J32 = "countries/Sahcabchen.txt"
J33 = "countries/Opilchen.txt"
J34 = "countries/Sibac.txt"
J35 = "countries/Huntulchac.txt"
J36 = "countries/Tiholop.txt"
J37 = "countries/Dzonotchel.txt"
J38 = "countries/Chikindzonot.txt"
J39 = "countries/Ekpedz.txt"
J40 = "countries/Tzalca.txt"
J41 = "countries/Catzim.txt"
J42 = "countries/TzitzilaCochuah.txt"
J43 = "countries/Xaya.txt"
J44 = "countries/Tituk.txt"
J45 = "countries/Saclac.txt"
J46 = "countries/Saban.txt"
J47 = "countries/Uaymax.txt"
J48 = "countries/Celul.txt"
J49 = "countries/Ichmul.txt"
J50 = "countries/Tihotzuc.txt"
J51 = "countries/Tepich.txt"
J52 = "countries/Tila.txt"
J53 = "countries/Kanpokolche.txt"
J54 = "countries/TabiCochuah.txt"
J55 = "countries/Chunhuhub.txt"
J56 = "countries/Polyuc.txt"
J57 = "countries/Muyil.txt"
J58 = "countries/ChanChen.txt"
J59 = "countries/Chumpon.txt"
J60 = "countries/Zamach.txt"
J61 = "countries/SianKaAn.txt"
J62 = "countries/Chancah.txt"
J63 = "countries/Huntichmul.txt"
J64 = "countries/Tzucacab.txt"
J65 = "countries/Pocha.txt"
J66 = "countries/Xoco.txt"
J67 = "countries/Bakhalal.txt"
J68 = "countries/Yuyumpeten.txt"
J69 = "countries/Macanahau.txt"
J70 = "countries/Chequitaquil.txt"
J71 = "countries/Xocomo.txt"
J72 = "countries/Chinam.txt"
J73 = "countries/Tamalcab.txt"
J74 = "countries/Ichpatun.txt"
J75 = "countries/Chactemal.txt"
J76 = "countries/Sajomal.txt"
J77 = "countries/Chunukum.txt"
J78 = "countries/Corosal.txt"
J79 = "countries/Nohmul.txt"
J80 = "countries/KAxob.txt"
J81 = "countries/Colha.txt"
J82 = "countries/Lamanai.txt"
J83 = "countries/Calmotz.txt"
J84 = "countries/Zacatan.txt"
J85 = "countries/Manan.txt"
J86 = "countries/Tipu.txt"
J87 = "countries/Ixpimienta.txt"
J88 = "countries/Holzuz.txt"
J89 = "countries/Soite.txt"
J90 = "countries/Campin.txt"
J91 = "countries/Paliac.txt"
J92 = "countries/Hampolol.txt"
J93 = "countries/Tiyoxcab.txt"
J94 = "countries/KaanPech.txt"
J95 = "countries/Samula.txt"
J96 = "countries/Tixbulul.txt"
J97 = "countries/Maxtun.txt"
J98 = "countries/Dzaptun.txt"
J99 = "countries/China.txt"
L01 = "countries/YaxaKaanPech.txt"
L02 = "countries/ChululKaanPech.txt"
L03 = "countries/Tixmucuy.txt"
L04 = "countries/SihoPlaya.txt"
L05 = "countries/Haltunchen.txt"
L06 = "countries/Chanputun.txt"
L07 = "countries/TichacChanputun.txt"
L08 = "countries/Kehte.txt"
L09 = "countries/Teop.txt"
L10 = "countries/BolonchenCouich.txt"
L11 = "countries/Couich.txt"
L12 = "countries/Uzkokallak.txt"
L13 = "countries/Chencan.txt"
L14 = "countries/Sobancuy.txt"
L15 = "countries/Tixchel.txt"
L16 = "countries/SahcabchenTixchel.txt"
L17 = "countries/Puslunich.txt"
L18 = "countries/Pixayal.txt"
L19 = "countries/Taschan.txt"
L20 = "countries/Chekubul.txt"
L21 = "countries/Chivajo.txt"
L22 = "countries/Chicbul.txt"
L23 = "countries/Pibil.txt"
L24 = "countries/Mamantel.txt"
L25 = "countries/Itzamkanak.txt"
L26 = "countries/Naranjal.txt"
L27 = "countries/Pocoiltun.txt"
L28 = "countries/Carmen.txt"
L29 = "countries/Xicalango.txt"
L30 = "countries/Palizada.txt"
L31 = "countries/Chinol.txt"
L32 = "countries/Potonchan.txt"
L33 = "countries/Chilapa.txt"
L34 = "countries/Chiltepec.txt"
L35 = "countries/Oxiacaque.txt"
L36 = "countries/Nojpeten.txt"
L37 = "countries/NixtonChiIch.txt"
L38 = "countries/ChakAn.txt"
L39 = "countries/ChakokOt.txt"
L40 = "countries/Uspeten.txt"
L41 = "countries/Ixlu.txt"
L42 = "countries/Zacpeten.txt"
L43 = "countries/Yalain.txt"
L44 = "countries/Topoxte.txt"
L45 = "countries/Nito.txt"
L46 = "countries/ToztlanTuxtla.txt"
L47 = "countries/ItzacChacalapan.txt"
L48 = "countries/Mixitlan.txt"
L49 = "countries/AnalcoTochtepec.txt"
L50 = "countries/Ayocintepec.txt"
L51 = "countries/Cuauhcuetzpaltepec.txt"
L52 = "countries/Totogal.txt"
L53 = "countries/Ranchoapan.txt"
L54 = "countries/Matacapan.txt"
L55 = "countries/Catemaco.txt"
L56 = "countries/Agaltepec.txt"
L57 = "countries/Coatlicamac.txt"
L58 = "countries/HueyXaltepec.txt"
L59 = "countries/Michapan.txt"
L60 = "countries/Azcaccan.txt"
L61 = "countries/Chacalapan.txt"
L62 = "countries/Nopiloa.txt"
L63 = "countries/Cotaxtla.txt"
L64 = "countries/MisantlaCempoallan.txt"
L65 = "countries/Paxil.txt"
L66 = "countries/NautlaCempoallan.txt"
L67 = "countries/Hueytepec.txt"
L68 = "countries/Tampico.txt"
L69 = "countries/Panuco.txt"
L70 = "countries/Tomohi.txt"
L71 = "countries/Tamtoc.txt"
L72 = "countries/Tamasopo.txt"
L73 = "countries/Tancanhuitz.txt"
L74 = "countries/Tancuayalab.txt"
L75 = "countries/Tanquian.txt"
L76 = "countries/NahuatlanHuaxteca.txt"
L77 = "countries/Ozuluama.txt"
L78 = "countries/Tempoal.txt"
L79 = "countries/Tantoyuca.txt"
L80 = "countries/Ixcatepec.txt"
L81 = "countries/Tepetzintla.txt"
L82 = "countries/Zacamixtle.txt"
L83 = "countries/Tamiahua.txt"
L84 = "countries/Chicantepec.txt"
L85 = "countries/Tlachichilco.txt"
L86 = "countries/Texcatepec.txt"
L87 = "countries/Huejutla.txt"
L88 = "countries/Tepantitla.txt"
L89 = "countries/Orizatlan.txt"
L90 = "countries/Tamazunchale.txt"
L91 = "countries/Cuajinicuilapa.txt"
L92 = "countries/Tepextla.txt"
L93 = "countries/Comaltepec.txt"
L94 = "countries/Acalmani.txt"
L95 = "countries/Putla.txt"
L96 = "countries/Tacubaya.txt"
L97 = "countries/Tepetlapa.txt"
L98 = "countries/Huixtepec.txt"
L99 = "countries/CacahuatepecHuaxyacac.txt"
M01 = "countries/Ipalapa.txt"
M02 = "countries/ZacatepecHuaxyacac.txt"
M03 = "countries/Ixtapa.txt"
M04 = "countries/Amapa.txt"
M05 = "countries/Chametla.txt"
M06 = "countries/Cuilacan.txt"
M07 = "countries/Teacapan.txt"
M08 = "countries/MazatlanIkalakian.txt"
M09 = "countries/Aztatlan.txt"
M10 = "countries/ComitlanTehuantepec.txt"
M11 = "countries/Iztactepec.txt"
M12 = "countries/TlacotepecTehuantepec.txt"
M13 = "countries/IxtepecTehuantepec.txt"
M14 = "countries/Chihuitlan.txt"
M15 = "countries/ChiltepecTehuantepec.txt"
M16 = "countries/AztatlanTehuantepec.txt"
M17 = "countries/Tepecuazontlan.txt"
M18 = "countries/Cuazontlan.txt"
M19 = "countries/Ocelotlan.txt"
M20 = "countries/Nectepec.txt"
M21 = "countries/Oztotla.txt"
M22 = "countries/Zanatepec.txt"
M23 = "countries/Tonaltepec.txt"
M24 = "countries/Tlapantepec.txt"
M25 = "countries/Izhuatlan.txt"
M26 = "countries/Chimalapa.txt"
M27 = "countries/Teotitlan.txt"
M28 = "countries/PetapaTehuantepec.txt"
M29 = "countries/Zetune.txt"
M30 = "countries/Nanacatepec.txt"
M31 = "countries/MazatlanTehuantepec.txt"
M32 = "countries/Ihualtepec.txt"
M33 = "countries/Atoyac.txt"
M34 = "countries/ZacatepecCuaxuapa.txt"
M35 = "countries/Chilistlahuaca.txt"
M36 = "countries/TonalaCuaxuapa.txt"
M37 = "countries/Tezuatlan.txt"
M38 = "countries/Tuchitlapilco.txt"
M39 = "countries/Huaxuapa.txt"
M40 = "countries/Tuctla.txt"
M41 = "countries/Huaxolotitlan.txt"
M42 = "countries/Cuyotepexi.txt"
M43 = "countries/Tequecistepec.txt"
M44 = "countries/Cuapanapa.txt"
M45 = "countries/Chiazumba.txt"
M46 = "countries/Ixcatlan.txt"
M47 = "countries/Quiotepec.txt"
M48 = "countries/Tecomavaca.txt"
M49 = "countries/Tecolutla.txt"
M50 = "countries/HueyTeotitlan.txt"
M51 = "countries/Nanahuaticpac.txt"
M52 = "countries/Nextepec.txt"
M53 = "countries/MazatlanTeotitlan.txt"
M54 = "countries/Cuautla.txt"
M55 = "countries/HuehuetlanTeotitlan.txt"
M56 = "countries/CuzcatlanTeotitlan.txt"
M57 = "countries/Zapotitlan.txt"
MM1 = "countries/Tehuacan.txt"
M59 = "countries/TepancoTehuacan.txt"
M60 = "countries/Chiapulco.txt"
M61 = "countries/Coyomeapa.txt"
M62 = "countries/ZoquitlanTehuacan.txt"
M63 = "countries/Ayuatlan.txt"
M64 = "countries/XalapanTochtepec.txt"
M65 = "countries/Ichcatlan.txt"
M66 = "countries/Miccoaztoc.txt"
M67 = "countries/Zoyatepec.txt"
M68 = "countries/Tzinacanoztoc.txt"
M69 = "countries/XicaltepecTochtepec.txt"
M70 = "countries/ChiltepecTochtepec.txt"
M71 = "countries/Xayaco.txt"
M72 = "countries/Quetzalapan.txt"
M73 = "countries/Tlaquatzintepec.txt"
M74 = "countries/Tesechoacan.txt"
M75 = "countries/Tlatela.txt"
M76 = "countries/TenampaCempoallan.txt"
M77 = "countries/TlacotepecCempoallan.txt"
M78 = "countries/Xilitla.txt"
M79 = "countries/TancanhuitzOxitipan.txt"
M80 = "countries/TamazunchaleOxitipan.txt"
M81 = "countries/Xacala.txt"
M82 = "countries/Chapulhuacan.txt"
M83 = "countries/Xalpantepec.txt"
M84 = "countries/PapaloticpacCuachinanco.txt"
M85 = "countries/Acaxete.txt"
M86 = "countries/Zoltepec.txt"
M87 = "countries/Nopaluca.txt"
M88 = "countries/Yahualtepec.txt"
M89 = "countries/Suchitlan.txt"
M90 = "countries/TlacotepecTepeacac.txt"
M91 = "countries/Acuatempa.txt"
M92 = "countries/Coyotepec.txt"
M93 = "countries/Atexcal.txt"
M94 = "countries/Tehuipanco.txt"
M95 = "countries/Shadowmasters.txt"
M96 = "countries/Tepapayeca.txt"
M97 = "countries/Xicocinco.txt"
M98 = "countries/Acuatlan.txt"
M99 = "countries/Atzitzihuacan.txt"
N01 = "countries/Teutlalco.txt"
N02 = "countries/IxtapanTemazcaltepec.txt"
N03 = "countries/Ozoloapan.txt"
N04 = "countries/Tecoanapa.txt"
N05 = "countries/Xocutla.txt"
N06 = "countries/Tecomastlahuaca.txt"
N07 = "countries/Justlahuaca.txt"
N08 = "countries/Puctla.txt"
N09 = "countries/TequecistepecTeposcolula.txt"
N10 = "countries/Astatlan.txt"
N11 = "countries/ChilapaTeposcolula.txt"
N12 = "countries/ChicahuastlaTeposcolula.txt"
N13 = "countries/OcotepecTeposcolula.txt"
N14 = "countries/Yutanino.txt"
N15 = "countries/Teoxomulco.txt"
N16 = "countries/Lachixio.txt"
N17 = "countries/Ayoquesco.txt"
N18 = "countries/Exutla.txt"
N19 = "countries/Lachila.txt"
N20 = "countries/Tanatze.txt"
N21 = "countries/Zoochila.txt"
N22 = "countries/Ayutla.txt"
N23 = "countries/Tlahuitoltepec.txt"
N24 = "countries/Atitlan.txt"
N25 = "countries/Chichicastepec.txt"
N26 = "countries/Betaza.txt"
N27 = "countries/Lalopa.txt"
N28 = "countries/Lobani.txt"
N29 = "countries/Totontepec.txt"
N30 = "countries/ComaltepecCoatlicamac.txt"
N31 = "countries/Yahuive.txt"
N32 = "countries/Latani.txt"
N33 = "countries/Teotalcinco.txt"
N34 = "countries/Puxmetacan.txt"
N35 = "countries/Tuxcacuexco.txt"
N36 = "countries/Ayutitlan.txt"
N37 = "countries/Chacala.txt"
N38 = "countries/ExutlaIcalaquiyan.txt"
N39 = "countries/AyamictlampaAyutitlan.txt"
N40 = "countries/Teclutlan.txt"
N41 = "countries/AyutlaIcalaquiyan.txt"
N42 = "countries/Tenamastlan.txt"
N43 = "countries/AtencoIcalaquiyan.txt"
N44 = "countries/Ameca.txt"
N45 = "countries/Tepapan.txt"
N46 = "countries/Tecomitl.txt"
N47 = "countries/Tepalcatlalpan.txt"
N48 = "countries/AtlapulcoXochimilco.txt"
N49 = "countries/Xico.txt"
N50 = "countries/Tlapacoyac.txt"
N51 = "countries/Guanahacabibes.txt"
N52 = "countries/Guaniguanico.txt"
N53 = "countries/Marien.txt"
N54 = "countries/Habana.txt"
N55 = "countries/Guanabacoa.txt"
N56 = "countries/Higueybacoa.txt"
N57 = "countries/Guanabo.txt"
N58 = "countries/Jaruco.txt"
N59 = "countries/Matabano.txt"
N60 = "countries/Hanabana.txt"
N61 = "countries/Jagua.txt"
N62 = "countries/Canarreo.txt"
N63 = "countries/Guamohaya.txt"
N64 = "countries/Magon.txt"
N65 = "countries/Omalay.txt"
N66 = "countries/Cubanacan.txt"
N67 = "countries/Sabaneque.txt"
N68 = "countries/Cabanaguey.txt"
N69 = "countries/Camaguey.txt"
N70 = "countries/Caonao.txt"
N71 = "countries/Guaimaros.txt"
N72 = "countries/Cueyba.txt"
N73 = "countries/Guaycanama.txt"
N74 = "countries/Guaramanao.txt"
N75 = "countries/Cayaguayo.txt"
N76 = "countries/GuaramanaoCayaguayo.txt"
N77 = "countries/Boyucari.txt"
N78 = "countries/Matuo.txt"
N79 = "countries/Guacanycarao.txt"
N80 = "countries/Maguayabon.txt"
N81 = "countries/Bani.txt"
N82 = "countries/Banibacoa.txt"
N83 = "countries/Guacamayabo.txt"
N84 = "countries/Bayamo.txt"
N85 = "countries/Malyo.txt"
N86 = "countries/Gualnaya.txt"
N87 = "countries/Maguanos.txt"
N88 = "countries/Banaxagua.txt"
N89 = "countries/Juragua.txt"
N90 = "countries/Sagua.txt"
N91 = "countries/Mayaguamo.txt"
N92 = "countries/Haymayoban.txt"
N93 = "countries/Baracoa.txt"
N94 = "countries/Macaca.txt"
N95 = "countries/Guajuanica.txt"
N96 = "countries/Sanlucar.txt"
N97 = "countries/Caney.txt"
N98 = "countries/Guamayaybon.txt"
N99 = "countries/Aguayguano.txt"
P01 = "countries/Guayguano.txt"
P02 = "countries/Haoco.txt"
P03 = "countries/Caguamo.txt"
P04 = "countries/Maisei.txt"
P05 = "countries/Sabano.txt"
P06 = "countries/Tliliuhquitepec.txt"
P07 = "countries/Nopala.txt"

#Special Countries - Formables/Invaders/Crazy Mechanics
Z01 = "countries/Tlaxcallan.txt"